

NO img/wall1.xpm
F 0,191,255

SO img/wall3.xpm





C 75,0,130


WE img/wall2.xpm
EA img/wall4.xpm

1111111111111111 1111111111111
1000000000110001 1000000000001
1011000001110001 100S000010001
100100000000000111000000010001
101100000111000000000000001001
100000000011000111111011110001
1111011111111101 1100000010001
1111011111111101 1101010010001
1100000011010101 1100000010001
1000000000000001 1100000010001
1000000000000001 1101010010001
1100000011010101 1000000000001
1111011111010101 1000001000001
1000000000110001 110001 110001
1000000000000001 1010011101001
1000000000100001 100101 101001
1000000000110101 1000001000001
1000000000010001 1001010000001
11111111111 1111 1111111111111
11111111111 1111 1111111111111
